1111111111111111111111111111111111
1E0001000110001C00000C010000010001
1010010100110010111001010101010101
1010010010011000011111010010001011
1P1000000100C0000000000001010000C1
1111111111111111111111111111111111