1111111111111
1E01000000001
1000001111101
1P0011C000001
1111111111111